0000001110000000
0000001010111100
0111001010100100
0101001010100100
0101111010100100
0100000010110100
0111100110010100
0000110100010100
2110010101110100
0010010101000100
0011110101000100
0000000101100100
0000000100100113
0001111100100000
0001000000100000
0001111111100000