0000000001111111
0000000001000001
0111110001000011
0100011111000010
0100000000000010
0111111111111010
0000000000001010
2111111111111010
0000000000000010
0111111111111110
0100000000000000
0111111111111110
0000000000000010
3111111111111110
0000000000000000
0000000000000000